10BBBBBBBBGB
BBBBGBBBBB
GBBGBBBBBB
BBBGBBBBBB
GGBBBGGGBG
BBBBBBBBBB
BBGGBBBBBB
BGBBBGBGBB
BBGBBBBBBG
BBBBBGBBBB
